,Year,Location,Male_Athletes,Female_Athletes,Total_Athletes
0,1896,Athens,241,0,241
1,1900,Paris,975,22,997
2,1904,St. Louis,645,6,651
3,1908,London,1971,37,2008
4,1912,Stockholm,2359,48,2407
5,1920,Antwerp,2561,65,2626
6,1924,Paris,2954,135,3089
7,1928,Amsterdam,2606,277,2883
8,1932,Los Angeles,1206,126,1332
9,1936,Berlin,3632,331,3963
10,1948,London,3714,390,4104
12,1956,Melbourne,2938,376,3314
